25 9
#############    ########        
#.0.........#    #......#
#.......v...######......#
#....................i..#
#.......................#
#....v..................#
#...................v...#
#....a..................#
#########################
